data,stato,codice_regione,denominazione_regione,lat,long,ricoverati_con_sintomi,terapia_intensiva,totale_ospedalizzati,isolamento_domiciliare,totale_positivi,variazione_totale_positivi,nuovi_positivi,dimessi_guariti,deceduti,casi_da_sospetto_diagnostico,casi_da_screening,totale_casi,tamponi,casi_testati,note,ingressi_terapia_intensiva,note_test,note_casi,totale_positivi_test_molecolare,totale_positivi_test_antigenico_rapido,tamponi_test_molecolare,tamponi_test_antigenico_rapido,codice_nuts_1,codice_nuts_2
2022-02-28T17:00:00,ITA,13,Abruzzo,42.35122196,13.39843823,386,14,400,61539,61939,86,459,198454,2958,,,263351,5017372,1165453,Sono stati eliminati 2 casi dei giorni passati in quanto 1 caso non paziente Covid ed 1 caso duplicato,2,,,157046,106305,2063943,2953429,ITF,ITF1
2022-02-28T17:00:00,ITA,17,Basilicata,40.63947052,15.80514834,95,1,96,19470,19566,-10,239,62804,762,,,83132,806266,307033,"Il numero totale dei decessi ne comprende n. 30 a carico di pazienti non residenti, deceduti in strutture ospedaliere della Regione Basilicata. ",0,,,57961,25171,615167,191099,ITF,ITF5
2022-02-28T17:00:00,ITA,18,Calabria,38.90597598,16.59440194,294,18,312,45742,46054,73,1613,167369,2091,,,215514,2281836,1740852,,3,,Si precisa che per mero errore  di trascrizione sono stati comunicati  29.663 casi confermati da test antigenico.,163261,52253,1498798,783038,ITF,ITF6
2022-02-28T17:00:00,ITA,15,Campania,40.83956555,14.25084984,742,45,787,130917,131704,-4488,1380,1064499,9751,,,1205954,13746207,4574435,,3,,"a seguito delle verifiche quotidiane si evince che 6 decessi registrati oggi, risalgono ad un periodo compreso tra il 07/12/2021 e il 25/02/2022",847334,358620,8052958,5693249,ITF,ITF3
2022-02-28T17:00:00,ITA,08,Emilia-Romagna,44.49436681,11.3417208,1422,76,1498,32517,34015,-2541,1521,1136254,15905,,,1186174,14511093,2628925,"Sono stati eliminati 1 casi, positivi a test antigenico ma non confermati da tampone molecolare. Sono stati eliminati 1 casi, comunicati nei giorni precedenti, in quanto giudicati non casi COVID-19.",3,,,850455,335719,8450844,6060249,ITH,ITH5
2022-02-28T17:00:00,ITA,06,Friuli Venezia Giulia,45.6494354,13.76813649,214,15,229,18583,18812,-553,186,284587,4776,,,308175,5760175,1084122,Il totale dei casi positivi è stato ridotto di 1 a seguito a seguito di 1 test positivo rimosso dopo revisione del caso (caso relativo alla provincia di PN).		 Si segnala che nei dati relativi agli ospedalizzati in Terapia Intensiva e Area Medica sono conteggiati tutti i pazienti risultati positivi a SARS-CoV2 ricoverati sia per Covid-19 che per altra patologia.		,0,,,182201,125974,3066963,2693212,ITH,ITH4
2022-02-28T17:00:00,ITA,12,Lazio,41.89277044,12.48366722,1412,122,1534,136912,138446,-5657,2324,925808,10426,,,1074680,17716039,5386626,,5,,,834525,240155,8089210,9626829,ITI,ITI4
2022-02-28T17:00:00,ITA,07,Liguria,44.41149315,8.9326992,352,18,370,13919,14289,-371,365,325514,5097,,,344900,4778912,1229263,,1,,*di cui  9500 reinfezioni a partire dal 3/09/2021 [circ. min sal. n.37911 del 20/08/2021].,213950,130950,2283356,2495556,ITC,ITC3
2022-02-28T17:00:00,ITA,03,Lombardia,45.46679409,9.190347404,1052,97,1149,117143,118292,-1866,1388,2175665,38603,,,2332560,32989784,7811842,,8,,,1321594,1010966,15027234,17962550,ITC,ITC4
2022-02-28T17:00:00,ITA,11,Marche,43.61675973,13.5188753,209,28,237,18461,18698,41,579,304785,3592,,,327075,2723577,1734060,,1,,,202261,124814,1916418,807159,ITI,ITI3
2022-02-28T17:00:00,ITA,14,Molise,41.55774754,14.65916051,25,2,27,6518,6545,135,140,31883,568,,,38996,485230,433179,,0,,,22398,16598,372612,112618,ITF,ITF2
2022-02-28T17:00:00,ITA,21,P.A. Bolzano,46.49933453,11.35662422,71,2,73,5327,5400,-236,194,181214,1413,,,188027,3648604,621648,,1,,,89519,98508,844595,2804009,ITH,ITH1
2022-02-28T17:00:00,ITA,22,P.A. Trento,46.06893511,11.12123097,54,6,60,3550,3610,-142,111,133845,1519,,,138974,2382959,532850,,0,,,42421,96553,822227,1560732,ITH,ITH2
2022-02-28T17:00:00,ITA,01,Piemonte,45.0732745,7.680687483,949,40,989,44537,45526,-1248,1342,919360,13030,,,977916,15209499,3714480,,4,,,474459,503457,4700545,10508954,ITC,ITC1
2022-02-28T17:00:00,ITA,16,Puglia,41.12559576,16.86736689,595,31,626,78694,79320,-346,1537,647246,7663,,,734229,8729786,2102026,,1,,,441502,292727,3977703,4752083,ITF,ITF4
2022-02-28T17:00:00,ITA,20,Sardegna,39.21531192,9.110616306,337,26,363,30932,31295,-359,385,142344,2048,,,175687,3762454,1459737,,3,,"L'incremento dei nuovi casi tiene conto anche dei casi diagnosticati con test antigenico, ai sensi di quando disposto con Ordinanza n. 2 del 3 febbraio 2022 del Presidente della Regione Sardegna. Pertanto si specifica che dei 385 casi dichiarati oggi, 328 sono stati diagnosticati da tampone antigenico Si segnala il decesso dei paz.:  - 1 uomo 87 aa Residente nella Città Metropolitana di Cagliari  - 1 uomo 73 aa Residente nella Città Metropolitana di Cagliari  - 1 donna 75 aa Residente nella Città Metropolitana di Cagliari  - 1 donna 74 aa Residente nella Città Metropolitana di Cagliari  - 1 donna 91 aa Residente nella Città Metropolitana di Cagliari  - 1 donna 86 aa Residente nella Provincia del Sud Sardegna  - 1 uomo 53 aa Residente nella Provincia del Sud Sardegna  - 1 donna 98 aa Residente nella Provincia del Sud Sardegna  - 1 uomo 81 aa Residente nella Provincia del Sud Sardegna  - 1 uomo 83 aa Residente nella Provincia di Sassari  - 1 uomo 64 aa Residente nella Provincia di Sassari  - 1 uomo 78 aa Residente nella Provincia di Nuoro  - 1 donna 82 aa Residente nella Provincia di Oristano ",141120,34567,1776615,1985839,ITG,ITG2
2022-02-28T17:00:00,ITA,19,Sicilia,38.11569725,13.3623567,1049,67,1116,227130,228246,-2499,1606,548568,9465,,,786279,10803649,5239126,DECEDUTI: N. 1 IL 28/02/2022 - N. 7 IL 27/02/2022 - N. 14 IL 26/02/2022 - N. 8 IL 25/02/2022 - N. 1 IL 20/02/2022 - N. 1 IL 17/01/2022 - N. 1 IL 14/01/2022 - N. 1 IL 12/01/2022 - N. 1 IL 07/01/2022 - N. 1 IL 03/01/2022,0,,"Sul numero complessivo dei casi confermati comunicati in data odierna, n. 302 sono relativi a giorni precedenti al 27/02/22 (di cui n. 297 del 26/02/22 e n. 2 del 25/02/22)			",479607,306672,4365547,6438102,ITG,ITG1
2022-02-28T17:00:00,ITA,09,Toscana,43.76923077,11.25588885,805,51,856,30193,31049,-1115,1008,815947,9028,,,856024,12178193,4351318,,2,,,553269,302755,6365150,5813043,ITI,ITI1
2022-02-28T17:00:00,ITA,10,Umbria,43.10675841,12.38824698,151,6,157,9260,9417,-119,311,173022,1733,,,184172,3699466,655841,- Si fa presente che 4 dei ricoveri non UTI appartengono ai codici disciplina di Ostetricia & Ginecologia e Pediatria. - Si fa presente che 4 dei ricoveri non UTI appartengono ad altri codici disciplina.,0,,,117867,66305,1522696,2176770,ITI,ITI2
2022-02-28T17:00:00,ITA,02,Valle d'Aosta,45.73750286,7.320149366,25,3,28,1329,1357,-22,40,29534,519,,,31410,467429,128229,"Con riferimento alla problematica sorta ieri dovuta ad un inconveniente tecnico che ha impedito l'estrazione dei dati dalla piattaforma, su richiesta del Ministero, si comunica che l'incremento dei casi confermati inserito oggi (40) è la somma dell'incremento dei casi riferito al 27/2 (30) e a quello riferito al 28/2 (10). ",0,,,13822,17588,134497,332932,ITC,ITC2
2022-02-28T17:00:00,ITA,05,Veneto,45.43490485,12.33845213,612,46,658,55696,56354,-1107,1253,1259433,13820,,,1329607,25637849,4548618,Nei valori riportati per le terapie intensive si è verificato un disallineamento temporale del flusso informativo pertanto per convenzione è stato riportato 5 dimessi da TI  invece del n. 3 effettivi che include anche i negativizzati.,2,,,742728,586879,9304687,16333162,ITH,ITH3
