data,stato,codice_regione,denominazione_regione,lat,long,ricoverati_con_sintomi,terapia_intensiva,totale_ospedalizzati,isolamento_domiciliare,totale_positivi,variazione_totale_positivi,nuovi_positivi,dimessi_guariti,deceduti,casi_da_sospetto_diagnostico,casi_da_screening,totale_casi,tamponi,casi_testati,note,ingressi_terapia_intensiva,note_test,note_casi,totale_positivi_test_molecolare,totale_positivi_test_antigenico_rapido,tamponi_test_molecolare,tamponi_test_antigenico_rapido,codice_nuts_1,codice_nuts_2
2022-01-20T17:00:00,ITA,13,Abruzzo,42.35122196,13.39843823,418,40,458,81001,81459,3748,4004,96670,2726,,,180855,4226001,1107202,"Dal totale dei positivi sono stati eliminati: 1 caso diagnosticato da antigenico e non confermati da molecolare e 1 caso in quanto non paziente Covid.  Nota informativa: Dal totale dei decessi comunicati in data odierna, 1 caso è avvenuto nei giorni scorsi.",6,,,125683,55172,1853489,2372512,ITF,ITF1
2022-01-20T17:00:00,ITA,17,Basilicata,40.63947052,15.80514834,91,4,95,15945,16040,606,1388,36108,664,,,52812,622660,280125,"Il numero totale dei decessi ne comprende n. 23 a carico di pazienti non residenti, deceduti in strutture ospedaliere della Regione Basilicata.  ",1,,,50428,2384,564527,58133,ITF,ITF5
2022-01-20T17:00:00,ITA,18,Calabria,38.90597598,16.59440194,435,35,470,39557,40027,1111,2785,112625,1766,,,154418,1903850,1498700,,4,,L'asp di Cosenza comunica 283 nuovi soggetti positivi di cui due fuori regione ,142468,11950,1370493,533357,ITF,ITF6
2022-01-20T17:00:00,ITA,15,Campania,40.83956555,14.25084984,1331,99,1430,245005,246435,-6031,16977,651553,8835,,,906823,11447524,4236718,,15,,"a seguito delle verifiche quotidiane si evince che cinque decessi registrati oggi, risalgono ad un periodo compreso tra il 7/01 e il 16/01",773866,132957,7304756,4142768,ITF,ITF3
2022-01-20T17:00:00,ITA,08,Emilia-Romagna,44.49436681,11.3417208,2465,152,2617,345823,348440,7493,20140,512193,14690,,,875323,12865778,2520924,"Sono stati eliminati 9 casi, comunicati nei giorni precedenti, in quanto giudicati non casi COVID-19.",20,,,692311,183012,7847931,5017847,ITH,ITH5
2022-01-20T17:00:00,ITA,06,Friuli Venezia Giulia,45.6494354,13.76813649,429,40,469,55833,56302,2399,5238,164693,4382,,,225377,5006822,1020722,Il totale dei casi positivi è stato ridotto di 7 a seguito di 5 tamponi molecolari negativi dopo test antigenico positivo (4 casi relativi alla provincia di UD e 1 caso relativo alla provincia di PN) e a seguito di 2 test positivi rimossi dopo revisione dei casi (1 caso relativo alla provincia di PN e 1 caso relativo alla provincia di TS).,2,,,159796,65581,2815999,2190823,ITH,ITH4
2022-01-20T17:00:00,ITA,12,Lazio,41.89277044,12.48366722,1915,202,2117,244656,246773,8198,13423,486952,9594,,,743319,14761574,5173978,,12,,,659827,83492,7408108,7353466,ITI,ITI4
2022-01-20T17:00:00,ITA,07,Liguria,44.41149315,8.9326992,725,41,766,34571,35337,2676,6882,205237,4769,,,245343,4026773,1133756,"Si precisa che nel flusso informativo degli ospedalizzati in Area Medica e Terapia Intensiva sono conteggiati tutti i pazienti SARS-CoV2 positivi ricoverati sia per patologia Covid-19 correlata sia per altre cause. Inoltre, si fa presente che i pazienti attualmente ospedalizzati per patologia non Covid-19 correlata ammontano a circa il 30% del totale degli ospedalizzati positivi per SARS-CoV2.",2,,*di cui 4582 reinfezioni a partire dal 3/09/2021 [circ. min sal. n.37911 del 20/08/2021].,186596,58747,2129424,1897349,ITC,ITC3
2022-01-20T17:00:00,ITA,03,Lombardia,45.46679409,9.190347404,3719,271,3990,514817,518807,19414,33676,1338495,36257,,,1893559,28648073,7378045,,14,,,1192356,701203,14034284,14613789,ITC,ITC4
2022-01-20T17:00:00,ITA,11,Marche,43.61675973,13.5188753,292,50,342,17903,18245,-7,6905,183259,3333,,,204837,2313937,1418084,,3,,,175473,29364,1775509,538428,ITI,ITI3
2022-01-20T17:00:00,ITA,14,Molise,41.55774754,14.65916051,18,1,19,8918,8937,291,415,16277,518,,,25732,378069,341880,,0,,,20229,5503,332021,46048,ITF,ITF2
2022-01-20T17:00:00,ITA,21,P.A. Bolzano,46.49933453,11.35662422,104,16,120,26340,26460,102,2989,110948,1336,,,138744,3272313,590374,Comunichiamo un totale netto di 2989 casi a cui abbiamo sotratto uno storno.,0,,,85020,53724,814209,2458104,ITH,ITH1
2022-01-20T17:00:00,ITA,22,P.A. Trento,46.06893511,11.12123097,145,20,165,27667,27832,198,2659,74326,1460,,,103618,2102255,502401,,1,,,40813,62805,807148,1295107,ITH,ITH2
2022-01-20T17:00:00,ITA,01,Piemonte,45.0732745,7.680687483,2056,143,2199,170172,172371,1802,15328,567842,12415,,,752628,12943185,3415120,,18,,,432160,320468,4393751,8549434,ITC,ITC1
2022-01-20T17:00:00,ITA,16,Puglia,41.12559576,16.86736689,691,63,754,132729,133483,-5520,8333,364991,7091,,,505565,7079241,1915785,,2,,I dati notificati in data odierna comprendono 8333 casi confermati nelle ultime 24 ore e 10086 casi diagnosticati con tampone antigenico rapido riconteggiati dal 01.01.2022. ,375173,130392,3622972,3456269,ITF,ITF4
2022-01-20T17:00:00,ITA,20,Sardegna,39.21531192,9.110616306,265,30,295,21885,22180,170,1432,88393,1780,,,112353,3111642,1333648,,6,,Si segnala il decesso dei paz.:  - 1 donna 84 aa Residente nella Provincia di Sassari  - 1 donna 87 aa Residente nella Città Metropolitana di Cagliari  - 1 donna 78 aa Residente nella Provincia del Sud Sardegna ,112249,104,1612341,1499301,ITG,ITG2
2022-01-20T17:00:00,ITA,19,Sicilia,38.11569725,13.3623567,1403,170,1573,195444,197017,6215,7997,346291,8087,,,551395,9332443,3788525,DECEDUTI: N. 3 IL 20/01/22 - N. 15 IL 19/01/22 - N. 13 IL 18/01/22 - N. 1 IL 17/01/22 - N. 1 IL 06/01/22 - N. 1 IL 04/01/22,13,,,451090,100305,4105596,5226847,ITG,ITG1
2022-01-20T17:00:00,ITA,09,Toscana,43.76923077,11.25588885,1330,124,1454,178537,179991,3632,13720,440184,7949,,,628124,10400821,4002107,,8,,,459984,168140,5860524,4540297,ITI,ITI1
2022-01-20T17:00:00,ITA,10,Umbria,43.10675841,12.38824698,202,11,213,25736,25949,-59,2133,108100,1577,,,135626,3254480,604266,Si fa presente che 9 dei ricoveri non UTI appartengono ai codici disciplina di Ostetricia & Ginecologia e Pediatria. ,1,,,100478,35148,1427572,1826908,ITI,ITI2
2022-01-20T17:00:00,ITA,02,Valle d'Aosta,45.73750286,7.320149366,78,6,84,5977,6061,190,540,19149,499,,,25709,410373,121054,,2,,,14518,11191,130856,279517,ITC,ITC2
2022-01-20T17:00:00,ITA,05,Veneto,45.43490485,12.33845213,1547,180,1727,272168,273895,8823,21833,669339,12862,,,956096,22004185,4343117,Nei valori riportati per le terapie intensive si è verificato un disallineamento temporale del flusso informativo pertanto per convenzione è stato riportato  19 dimessi da TI  invece del n. 17 effettivi che include anche i negativizzati.,25,,,653562,302534,8781177,13223008,ITH,ITH3
