data,stato,codice_regione,denominazione_regione,lat,long,ricoverati_con_sintomi,terapia_intensiva,totale_ospedalizzati,isolamento_domiciliare,totale_positivi,variazione_totale_positivi,nuovi_positivi,dimessi_guariti,deceduti,casi_da_sospetto_diagnostico,casi_da_screening,totale_casi,tamponi,casi_testati,note,ingressi_terapia_intensiva,note_test,note_casi,totale_positivi_test_molecolare,totale_positivi_test_antigenico_rapido,tamponi_test_molecolare,tamponi_test_antigenico_rapido,codice_nuts_1,codice_nuts_2
2022-03-22T17:00:00,ITA,13,Abruzzo,42.35122196,13.39843823,277,13,290,40948,41238,2129,2904,250946,3049,,,295233,5293237,1186373,Dal totale dei positivi è stato sottratto 1 caso perché non COVID. Dal totale dei deceduti due casi sono avvenuti nei giorni passati,0,,,165714,129519,2140696,3152541,ITF,ITF1
2022-03-22T17:00:00,ITA,17,Basilicata,40.63947052,15.80514834,102,4,106,22033,22139,615,1269,75230,814,,,98183,876208,320726,"Il numero totale dei decessi ne comprende n. 32 a carico di pazienti non residenti, deceduti in strutture ospedaliere della Regione Basilicata.",1,,,60821,37362,630776,245432,ITF,ITF5
2022-03-22T17:00:00,ITA,18,Calabria,38.90597598,16.59440194,377,13,390,65775,66165,1597,3994,201932,2234,,,270331,2536868,1928459,,3,,L'ASP di Cosenza comunica 1248 nuovi soggetti positivi di cui 11 fuori regione.,172757,97574,1561337,975531,ITF,ITF6
2022-03-22T17:00:00,ITA,15,Campania,40.83956555,14.25084984,615,35,650,149595,150245,4376,10788,1166610,9956,,,1326811,14498630,4683164,,4,,"a seguito delle verifiche quotidiane si evince che quindici decessi registrati oggi, risalgono ad un periodo compreso tra il 01/02 e il 19/03 2022",868182,458629,8272857,6225773,ITF,ITF3
2022-03-22T17:00:00,ITA,08,Emilia-Romagna,44.49436681,11.3417208,950,53,1003,38850,39853,751,2758,1188330,16171,,,1244354,14917229,2661983,"Sono stati eliminati 3 casi, comunicati nei giorni precedenti, in quanto giudicati non casi COVID-19.",7,,,869904,374450,8655306,6261923,ITH,ITH5
2022-03-22T17:00:00,ITA,06,Friuli Venezia Giulia,45.6494354,13.76813649,134,4,138,21133,21271,745,1433,298555,4871,,,324697,5974971,1099327,Il totale dei casi positivi è stato ridotto di 1 a seguito di 1 tampone molecolare negativo dopo test antigenico positivo (caso relativo alla provincia di UD).                		,2,,,187111,137586,3152301,2822670,ITH,ITH4
2022-03-22T17:00:00,ITA,12,Lazio,41.89277044,12.48366722,1081,72,1153,107796,108949,4020,11172,1091029,10671,,,1210649,18805563,5477523,,2,,,880042,330607,8314995,10490568,ITI,ITI4
2022-03-22T17:00:00,ITA,07,Liguria,44.41149315,8.9326992,251,8,259,16105,16364,647,2262,350506,5180,,,372050,4998808,1257020,,0,,*di cui 10890 reinfezioni a partire dal 3/09/2021 [circ. min sal. n.37911 del 20/08/2021].,220171,151879,2341962,2656846,ITC,ITC3
2022-03-22T17:00:00,ITA,03,Lombardia,45.46679409,9.190347404,934,45,979,140574,141553,2406,11378,2280268,39092,,,2460913,34332761,7948047,,0,,,1347927,1112986,15353705,18979056,ITC,ITC4
2022-03-22T17:00:00,ITA,11,Marche,43.61675973,13.5188753,214,6,220,16005,16225,13,3513,349638,3672,,,369535,2836540,1832222,,1,,,206497,163038,1945701,890839,ITI,ITI3
2022-03-22T17:00:00,ITA,14,Molise,41.55774754,14.65916051,25,1,26,7783,7809,45,288,37056,585,,,45450,511478,471633,,1,,,23435,22015,389780,121698,ITF,ITF2
2022-03-22T17:00:00,ITA,21,P.A. Bolzano,46.49933453,11.35662422,72,5,77,5807,5884,285,1201,193174,1436,,,200494,3750920,631245,L'incremento dei casi confermati è diverso da quello calcolato perché il numero dei guariti del giorno precedente è stato sovrastimato della stessa differenza (331).,0,,1201 nuovi positivi di cui 6 test antigenici confermati da test molecolare e 1147 test antigenici. L'incremento dei casi confermati è diverso da quello calcolato perché il numero dei guariti del giorno precedente è stato sovrastimato della stessa differenza (331).,90383,110111,856916,2894004,ITH,ITH1
2022-03-22T17:00:00,ITA,22,P.A. Trento,46.06893511,11.12123097,39,1,40,3430,3470,31,500,140765,1536,,,145771,2457855,541849,,0,,,42669,103102,827904,1629951,ITH,ITH2
2022-03-22T17:00:00,ITA,01,Piemonte,45.0732745,7.680687483,568,23,591,48736,49327,589,3345,962557,13166,,,1025050,15844145,3792086,,7,,,483317,541733,4787898,11056247,ITC,ITC1
2022-03-22T17:00:00,ITA,16,Puglia,41.12559576,16.86736689,620,32,652,107300,107952,3868,12007,736005,7875,,,851832,9391623,2175829,,7,,,457322,394510,4103541,5288082,ITF,ITF4
2022-03-22T17:00:00,ITA,20,Sardegna,39.21531192,9.110616306,330,19,349,29118,29467,513,3131,180945,2167,,,212579,3987198,1510604,,0,,"L'incremento dei nuovi casi tiene conto anche dei casi diagnosticati con test antigenico, ai sensi di quando disposto con Ordinanza n. 2 del 3 febbraio 2022 del Presidente della Regione Sardegna. Pertanto si specifica che dei 3131 casi dichiarati oggi, 2754 sono stati diagnosticati da tampone antigenico. Si segnala il decesso dei paz.:  - 1 donna 90 aa Residente nella Città Metropolitana di Cagliari  - 1 donna 91 aa Residente nella Città Metropolitana di Cagliari  - 1 donna 92 aa Residente nella Provincia del Sud Sardegna  - 1 uomo 81 aa Residente nella Provincia di Oristano  - 1 donna 96 aa Residente nella Provincia di Oristano  - 1 uomo 79 aa Residente nella Provincia di Oristano  - 1 donna 68 aa Residente nella Provincia di Oristano  - 1 uomo 73 aa Residente nella Provincia di Sassari ",147577,65002,1846030,2141168,ITG,ITG2
2022-03-22T17:00:00,ITA,19,Sicilia,38.11569725,13.3623567,946,59,1005,236784,237789,-700,6726,669368,9898,,,917055,11491463,5919684,DECEDUTI: N. 9 IL 21/03/2022 - N. 10 IL 20/03/2022 - N. 3 IL 19/03/2022 - N. 2 IL 18/03/2022 - N. 1 IL 22/02/2022 - N. 1 IL 24/01/2022 - N. 1 IL 17/01/2022 - N. 1 IL 16/01/2022 - N. 1 IL 01/01/2022 - N. 1 IL 24/12/2021,6,,"Sul numero complessivo dei casi confermati comunicati in data odierna, n. 875 sono relativi a giorni precedenti al 21/03/22  (di cui n. 689 del 20/03/22, n. 82 del 19/03/22, n. 71 del 18/03/22)",489666,427389,4473168,7018295,ITG,ITG1
2022-03-22T17:00:00,ITA,09,Toscana,43.76923077,11.25588885,757,33,790,43785,44575,1514,6778,886414,9365,,,940354,12765621,4499016,,4,,,577952,362402,6519523,6246098,ITI,ITI1
2022-03-22T17:00:00,ITA,10,Umbria,43.10675841,12.38824698,192,4,196,20870,21066,84,2474,195906,1778,,,218750,3906703,682281,- Si fa presente che 5 dei ricoveri non UTI appartengono ai codici disciplina di Ostetricia & Ginecologia e Pediatria. - Si fa presente che 18 dei ricoveri non UTI appartengono ad altri codici disciplina.,0,,,126496,92254,1568151,2338552,ITI,ITI2
2022-03-22T17:00:00,ITA,02,Valle d'Aosta,45.73750286,7.320149366,18,0,18,1112,1130,-36,89,30410,523,,,32063,482612,130056,,0,,,13649,18414,136026,346586,ITC,ITC2
2022-03-22T17:00:00,ITA,05,Veneto,45.43490485,12.33845213,467,25,492,67644,68136,1835,8355,1347740,14062,,,1429938,26912180,4630250,Nei valori riportati per le terapie intensive si è verificato un disallineamento temporale del flusso informativo pertanto per convenzione è stato riportato 4 dimessi da TI  invece del n. 3 effettivi che include anche i negativizzati.,2,,,761362,668576,9517613,17394567,ITH,ITH3
