data,stato,codice_regione,denominazione_regione,lat,long,ricoverati_con_sintomi,terapia_intensiva,totale_ospedalizzati,isolamento_domiciliare,totale_positivi,variazione_totale_positivi,nuovi_positivi,dimessi_guariti,deceduti,casi_da_sospetto_diagnostico,casi_da_screening,totale_casi,tamponi,casi_testati,note,ingressi_terapia_intensiva,note_test,note_casi,totale_positivi_test_molecolare,totale_positivi_test_antigenico_rapido,tamponi_test_molecolare,tamponi_test_antigenico_rapido,codice_nuts_1,codice_nuts_2
2022-02-14T17:00:00,ITA,13,Abruzzo,42.35122196,13.39843823,492,25,517,105620,106137,-349,725,135382,2883,,,244402,4823017,1152630,"Dal totale casi positivi è stato eliminato 1 caso dei giorni passati in quanto duplicato. Dei decessi comunicati in data odierna, 1 decesso è avvenuto nei giorni scorsi.",1,,,149679,94723,2005321,2817696,ITF,ITF1
2022-02-14T17:00:00,ITA,17,Basilicata,40.63947052,15.80514834,98,5,103,20015,20118,-24,325,54536,718,,,75372,759164,298201,"Il numero totale dei decessi ne comprende n. 25 a carico di pazienti non residenti, deceduti in strutture ospedaliere della Regione Basilicata. ",0,,,56230,19142,603442,155722,ITF,ITF5
2022-02-14T17:00:00,ITA,18,Calabria,38.90597598,16.59440194,349,31,380,45441,45821,-282,904,145250,2008,,,193079,2144828,1658119,,2,,L' Asp di Reggio Calabria comunica 539 nuovi soggetti positivi di cui 2 fuori regione,157715,35364,1455736,689092,ITF,ITF6
2022-02-14T17:00:00,ITA,15,Campania,40.83956555,14.25084984,1213,73,1286,168262,169548,-7405,3035,963782,9548,,,1142878,13220091,4507791,,4,,"a seguito delle verifiche quotidiane si evince che 11 decessi registrati oggi, risalgono ad un periodo compreso tra il 9/02 e l'11/02",834085,308793,7876040,5344051,ITF,ITF3
2022-02-14T17:00:00,ITA,08,Emilia-Romagna,44.49436681,11.3417208,2118,113,2231,79029,81260,-8678,2695,1050413,15592,,,1147265,14201632,2610774,"Sono stati eliminati 6 casi, comunicati nei giorni precedenti, in quanto giudicati non casi COVID-19.",2,,,835482,311783,8313414,5888218,ITH,ITH5
2022-02-14T17:00:00,ITA,06,Friuli Venezia Giulia,45.6494354,13.76813649,401,33,434,33567,34001,-1231,458,258208,4649,,,296858,5588281,1073544,Il totale dei casi positivi è stato ridotto di 6 a seguito di 4 tamponi molecolari negativi dopo test antigenico positivo (1 caso relativo alla provincia di UD e 2 casi relativi alla provincia di PN e 1 caso relativo alla provincia di TS) e a seguito di 2 test positivi rimossi dopo revisione dei casi (1 caso relativo alla provincia di PN e 1 caso relativo alla provincia di GO).		 Si segnala che nei dati relativi agli ospedalizzati in Terapia Intensiva e Area Medica sono conteggiati tutti i pazienti risultati positivi a SARS-CoV2 ricoverati sia per Covid-19 che per altra patologia.		,1,,,178666,118192,2998880,2589401,ITH,ITH4
2022-02-14T17:00:00,ITA,12,Lazio,41.89277044,12.48366722,1861,180,2041,232585,234626,-9499,3659,756477,10142,,,1001245,16990943,5329053,,6,,,799318,201927,7920918,9070025,ITI,ITI4
2022-02-14T17:00:00,ITA,07,Liguria,44.41149315,8.9326992,595,24,619,23746,24365,-845,543,299494,5002,,,328861,4619130,1212408,"Si precisa che nel flusso informativo degli ospedalizzati in Area Medica e Terapia Intensiva sono conteggiati tutti i pazienti SARS-CoV2 positivi ricoverati sia per patologia Covid-19 correlata sia per altre causa. Inoltre, si fa presente che i pazienti attualmente ospedalizzati per patologia non Covid-19 correlata ammontano a circa il 30% del totale degli ospedalizzati positivi per SARS-CoV2.",2,,*di cui  8594 reinfezioni a partire dal 3/09/2021 [circ. min sal. n.37911 del 20/08/2021].,209330,119531,2239577,2379553,ITC,ITC3
2022-02-14T17:00:00,ITA,03,Lombardia,45.46679409,9.190347404,1913,162,2075,171656,173731,-10890,1982,2052519,38076,,,2264326,32072076,7731864,,3,,,1304761,959565,14791931,17280145,ITC,ITC4
2022-02-14T17:00:00,ITA,11,Marche,43.61675973,13.5188753,310,42,352,23575,23927,910,1024,276569,3507,,,304003,2641690,1675495,,2,,,198016,105987,1881772,759918,ITI,ITI3
2022-02-14T17:00:00,ITA,14,Molise,41.55774754,14.65916051,43,5,48,7730,7778,92,153,26843,555,,,35176,456105,407113,,0,,,21820,13356,360609,95496,ITF,ITF2
2022-02-14T17:00:00,ITA,21,P.A. Bolzano,46.49933453,11.35662422,105,8,113,10070,10183,-486,441,167716,1386,,,179285,3559744,615303,,1,,,88807,90478,836290,2723454,ITH,ITH1
2022-02-14T17:00:00,ITA,22,P.A. Trento,46.06893511,11.12123097,123,14,137,7447,7584,-380,225,124968,1498,,,134050,2324369,526594,,0,,,42199,91851,818118,1506251,ITH,ITH2
2022-02-14T17:00:00,ITA,01,Piemonte,45.0732745,7.680687483,1644,74,1718,64813,66531,-3690,2497,866681,12849,,,946061,14707755,3664301,,4,,,468713,477348,4628240,10079515,ITC,ITC1
2022-02-14T17:00:00,ITA,16,Puglia,41.12559576,16.86736689,741,64,805,95554,96359,-719,2238,577676,7439,,,681474,8324021,2054038,,10,,,429103,252371,3883253,4440768,ITF,ITF4
2022-02-14T17:00:00,ITA,20,Sardegna,39.21531192,9.110616306,403,30,433,33986,34419,32,993,117584,1948,,,153951,3613518,1425114,,4,,"L'incremento dei nuovi casi tiene conto anche dei casi diagnosticati con test antigenico, ai sensi di quando disposto con Ordinanza n. 2 del 3 febbraio 2022 del Presidente della Regione Sardegna. Pertanto si specifica che dei 993 casi dichiarati oggi, 745 sono stati diagnosticati da tampone antigenico Si segnala il decesso dei paz.:  - 1 uomo 60 aa Residente nella Provincia di Oristano  - 1 donna 90 aa Residente nella Provincia del Sud Sardegna  - 1 donna 83 aa Residente nella Città Metropolitana di Cagliari  - 1 donna 76 aa Residente nella Città Metropolitana di Cagliari  - 1 uomo 92 aa Residente nella Provincia del Sud Sardegna  - 1 uomo 53 aa Residente nella Provincia di Sassari  - 1 uomo 82 aa Residente nella Provincia di Sassari  - 3 deceduti in Provincia di Nuoro ",137385,16566,1730246,1883272,ITG,ITG2
2022-02-14T17:00:00,ITA,19,Sicilia,38.11569725,13.3623567,1314,116,1430,259470,260900,894,2524,446337,9055,,,716292,10351588,4792338,DECEDUTI: N. 2 IL 14/02/2022 - N. 3 IL 13/02/2022 - N. 10 IL 12/02/2022 - N. 4 IL 11/02/2022,7,,"Sul numero complessivo dei casi confermati comunicati in data odierna, n. 159 sono relativi a giorni precedenti al 11/02/22                    			",472750,243542,4295090,6056498,ITG,ITG1
2022-02-14T17:00:00,ITA,09,Toscana,43.76923077,11.25588885,1108,85,1193,70365,71558,-2325,1680,736501,8666,,,816725,11794912,4275903,,10,,,539024,277701,6250464,5544448,ITI,ITI1
2022-02-14T17:00:00,ITA,10,Umbria,43.10675841,12.38824698,202,8,210,14109,14319,-348,375,156898,1692,,,172909,3582900,643780,- Si fa presente che 7 dei ricoveri non UTI appartengono ai codici disciplina di Ostetricia & Ginecologia e Pediatria. - Si fa presente che 10 dei ricoveri non UTI appartengono ad altri codici disciplina.,2,,,114386,58523,1496068,2086832,ITI,ITI2
2022-02-14T17:00:00,ITA,02,Valle d'Aosta,45.73750286,7.320149366,40,4,44,1970,2014,-105,9,28236,514,,,30764,455338,126413,,0,,,13934,16830,133391,321947,ITC,ITC2
2022-02-14T17:00:00,ITA,05,Veneto,45.43490485,12.33845213,977,77,1054,104382,105436,-2730,2145,1150470,13569,,,1269475,24751347,4506934,Nei valori riportati per le terapie intensive si è verificato un disallineamento temporale del flusso informativo pertanto per convenzione è stato riportato 0  dimessi da TI  invece del n. 1 effettivo che include anche i negativizzati. ,2,,,732665,536810,9158748,15592599,ITH,ITH3
