data,stato,codice_regione,denominazione_regione,lat,long,ricoverati_con_sintomi,terapia_intensiva,totale_ospedalizzati,isolamento_domiciliare,totale_positivi,variazione_totale_positivi,nuovi_positivi,dimessi_guariti,deceduti,casi_da_sospetto_diagnostico,casi_da_screening,totale_casi,tamponi,casi_testati,note,ingressi_terapia_intensiva,note_test,note_casi,totale_positivi_test_molecolare,totale_positivi_test_antigenico_rapido,tamponi_test_molecolare,tamponi_test_antigenico_rapido,codice_nuts_1,codice_nuts_2
2022-03-11T17:00:00,ITA,13,Abruzzo,42.35122196,13.39843823,245,13,258,28642,28900,650,1378,243948,3019,,,275867,5148097,1174290,Dal totale dei positivi sono stati eliminati 7 casi in quanto duplicati. Nota Informativa: Del totale dei deceduti 2 sono riferiti a giorni precedenti.,1,,,161061,114806,2102526,3045571,ITF,ITF1
2022-03-11T17:00:00,ITA,17,Basilicata,40.63947052,15.80514834,91,0,91,17744,17835,-219,724,70584,790,,,89209,838115,312968,"Il numero totale dei decessi ne comprende n. 30 a carico di pazienti non residenti, deceduti in strutture ospedaliere della Regione Basilicata. ",0,,,59183,30026,622945,215170,ITF,ITF5
2022-03-11T17:00:00,ITA,18,Calabria,38.90597598,16.59440194,309,16,325,48750,49075,1049,2451,187041,2171,,,238287,2401548,1826656,L'Asp di Cosenza comunica che nel setting fuori regione si registrano 4 nuovi casi a domicilio e 1 dimesso guarito,1,,,167579,70708,1529709,871839,ITF,ITF6
2022-03-11T17:00:00,ITA,15,Campania,40.83956555,14.25084984,545,25,570,123170,123740,-812,5001,1117139,9873,,,1250752,14085542,4620387,,4,,"a seguito delle verifiche quotidiane si evince che due decessi registrati oggi, risalgono ai giorni 28/01 e 26/02 2022",856008,394744,8163404,5922138,ITF,ITF3
2022-03-11T17:00:00,ITA,08,Emilia-Romagna,44.49436681,11.3417208,1048,58,1106,27812,28918,738,2910,1165221,16058,,,1210197,14711283,2643899,"Sono stati eliminati 10 casi, comunicati nei giorni precedenti, in quanto giudicati non casi COVID-19.",2,,,858861,351336,8552487,6158796,ITH,ITH5
2022-03-11T17:00:00,ITA,06,Friuli Venezia Giulia,45.6494354,13.76813649,150,10,160,17322,17482,86,640,292623,4824,,,314929,5871763,1091265,Il totale dei casi positivi è stato ridotto di 2 a seguito di 1 test positivo rimosso dopo revisione del caso (1 caso relativo alla provincia di GO) e a seguito di 1 test positivo rimosso dopo revisione del caso (caso relativo alla provincia di UD).		 Si segnala che nei dati relativi agli ospedalizzati in Terapia Intensiva e Area Medica sono conteggiati tutti i pazienti risultati positivi a SARS-CoV2 ricoverati sia per Covid-19 che per altra patologia.		,0,,,184467,130462,3112331,2759432,ITH,ITH4
2022-03-11T17:00:00,ITA,12,Lazio,41.89277044,12.48366722,1046,73,1119,96226,97345,-2164,6052,1016445,10563,,,1124353,18225366,5431943,,5,,,857334,267019,8207574,10017792,ITI,ITI4
2022-03-11T17:00:00,ITA,07,Liguria,44.41149315,8.9326992,234,14,248,12573,12821,111,1209,338752,5150,,,356723,4890251,1242511,,1,,*di cui  10121 reinfezioni a partire dal 3/09/2021 [circ. min sal. n.37911 del 20/08/2021]. ,216692,140031,2314448,2575803,ITC,ITC3
2022-03-11T17:00:00,ITA,03,Lombardia,45.46679409,9.190347404,783,73,856,111194,112050,416,5861,2234053,38889,,,2384992,33659816,7874726,,4,,,1333563,1051429,15199520,18460296,ITC,ITC4
2022-03-11T17:00:00,ITA,11,Marche,43.61675973,13.5188753,167,16,183,14215,14398,-1,1528,326024,3626,,,344048,2776613,1773859,,2,,,204116,139932,1935418,841195,ITI,ITI3
2022-03-11T17:00:00,ITA,14,Molise,41.55774754,14.65916051,19,3,22,6050,6072,85,264,35279,577,,,41928,500429,451887,,0,,,22891,19037,381235,119194,ITF,ITF2
2022-03-11T17:00:00,ITA,21,P.A. Bolzano,46.49933453,11.35662422,57,2,59,5119,5178,110,661,187462,1424,,,194064,3706458,626215,,0,,,89919,104145,850576,2855882,ITH,ITH1
2022-03-11T17:00:00,ITA,22,P.A. Trento,46.06893511,11.12123097,41,2,43,2894,2937,-32,294,137662,1527,,,142126,2421505,537175,,0,,,42553,99573,825325,1596180,ITH,ITH2
2022-03-11T17:00:00,ITA,01,Piemonte,45.0732745,7.680687483,590,29,619,42311,42930,200,1945,942292,13117,,,998339,15531018,3751222,,2,,,477396,520943,4747731,10783287,ITC,ITC1
2022-03-11T17:00:00,ITA,16,Puglia,41.12559576,16.86736689,529,30,559,77028,77587,981,4748,692177,7779,,,777543,9018937,2136801,,2,,,448761,328782,4040913,4978024,ITF,ITF4
2022-03-11T17:00:00,ITA,20,Sardegna,39.21531192,9.110616306,308,18,326,23328,23654,3,1696,165198,2111,,,190963,3870455,1485124,,1,,"L'incremento dei nuovi casi tiene conto anche dei casi diagnosticati con test antigenico, ai sensi di quando disposto con Ordinanza n. 2 del 3 febbraio 2022 del Presidente della Regione Sardegna. Pertanto si specifica che dei 1696 casi dichiarati oggi, 1407 sono stati diagnosticati da tampone antigenico Si segnala il decesso dei paz.:  - 1 uomo 77 aa Residente nella Città Metropolitana di Cagliari  - 1 donna 71 aa Residente nella Città Metropolitana di Cagliari  - 1 donna 90 aa Residente nella Provincia del Sud Sardegna  - 1 uomo 100 aa Residente nella Provincia di Sassari  - 1 uomo 90 aa Residente nella Provincia del Sud Sardegna ",143713,47250,1810981,2059474,ITG,ITG2
2022-03-11T17:00:00,ITA,19,Sicilia,38.11569725,13.3623567,868,65,933,222739,223672,1251,5497,611140,9721,,,844533,11140630,5572660,DECEDUTI: N. 6 IL 10/03/2022 - N. 11 IL 09/03/2022 - N. 4 IL 08/03/2022 - N. 1 IL 06/03/2022 - N. 1 IL 07/02/2022 - N. 1 IL 04/02/2022 - N. 1 IL 25/01/2022,3,,"Sul numero complessivo dei casi confermati comunicati in data odierna, n. 1159 sono relativi a giorni precedenti al 10/03/22 			",484533,360000,4422342,6718288,ITG,ITG1
2022-03-11T17:00:00,ITA,09,Toscana,43.76923077,11.25588885,644,42,686,25761,26447,1138,3938,853026,9202,,,888675,12452708,4413732,,4,,,563314,325361,6440241,6012467,ITI,ITI1
2022-03-11T17:00:00,ITA,10,Umbria,43.10675841,12.38824698,149,3,152,13318,13470,1024,1836,182179,1756,,,197405,3794080,667156,- Si fa presente che 3 dei ricoveri non UTI appartengono ai codici disciplina di Ostetricia & Ginecologia e Pediatria. - Si fa presente che 6 dei ricoveri non UTI appartengono ad altri codici disciplina.,0,,,121452,75953,1544424,2249656,ITI,ITI2
2022-03-11T17:00:00,ITA,02,Valle d'Aosta,45.73750286,7.320149366,15,1,16,986,1002,-332,33,30046,522,,,31570,475224,129181,"Si comunica che sono in corso per questa Regione delle attività di riallineamento dei dati di coloro che sono risultati positivi in Regione e poi trasferiti nella Regione di residenza, per cui ne risulta un differenziale, dei casi confermati positivi, negativo. Si comunica, comunque, l'incremento dei casi confermati positivi giornaliero che è di n. 33. Per lo stesso motivo il dato delle persone testate è in corso di riallineamento, per cui è stato riportato il dato uguale di ieri. Cordiali saluti.",0,,,13755,17815,135354,339870,ITC,ITC2
2022-03-11T17:00:00,ITA,05,Veneto,45.43490485,12.33845213,436,34,470,50496,50966,1042,4461,1307040,13950,,,1371956,26292973,4586388,Nei valori riportati per le terapie intensive si è verificato un disallineamento temporale del flusso informativo pertanto per convenzione è stato riportato 7 dimessi da TI  invece del n. 4 effettivi che include anche i negativizzati.,3,,,751257,620699,9415895,16877078,ITH,ITH3
