data,stato,codice_regione,denominazione_regione,lat,long,ricoverati_con_sintomi,terapia_intensiva,totale_ospedalizzati,isolamento_domiciliare,totale_positivi,variazione_totale_positivi,nuovi_positivi,dimessi_guariti,deceduti,casi_da_sospetto_diagnostico,casi_da_screening,totale_casi,tamponi,casi_testati,note,ingressi_terapia_intensiva,note_test,note_casi,totale_positivi_test_molecolare,totale_positivi_test_antigenico_rapido,tamponi_test_molecolare,tamponi_test_antigenico_rapido,codice_nuts_1,codice_nuts_2
2022-02-24T17:00:00,ITA,13,Abruzzo,42.35122196,13.39843823,416,14,430,69344,69774,613,1328,186986,2945,,,259705,4977106,1162857,Del totale dei decessi comunicati in data odierna 1 è avvenuto nei giorni scorsi.,1,,,155518,104187,2051096,2926010,ITF,ITF1
2022-02-24T17:00:00,ITA,17,Basilicata,40.63947052,15.80514834,111,2,113,19672,19785,-56,502,60980,744,,,81509,795793,305094,"Il numero totale dei decessi ne comprende n. 29 a carico di pazienti non residenti, deceduti in strutture ospedaliere della Regione Basilicata. ",0,,,57578,23931,612561,183232,ITF,ITF5
2022-02-24T17:00:00,ITA,18,Calabria,38.90597598,16.59440194,301,25,326,46012,46338,281,1580,161602,2070,,,210010,2243829,1717408,"L'ASP di Cosenza  comunica :""Nel setting fuori regione si registra un nuovo caso a domicilio ed un decesso tra i pazienti ricoverati""",1,,,162197,47813,1488292,755537,ITF,ITF6
2022-02-24T17:00:00,ITA,15,Campania,40.83956555,14.25084984,870,57,927,141514,142441,-2024,4252,1042608,9703,,,1194752,13636582,4561531,,3,,a seguito delle verifiche quotidiane si evince che tre decessi registrati oggi risalgono al periodo compreso tra il 19/02 e il 20/02 2022,844789,349963,8012395,5624187,ITF,ITF3
2022-02-24T17:00:00,ITA,08,Emilia-Romagna,44.49436681,11.3417208,1564,95,1659,41450,43109,-1403,2753,1118444,15838,,,1177391,14447053,2624902,"Sono stati eliminati 3 casi, comunicati nei giorni precedenti, in quanto giudicati non casi COVID-19.",2,,,847114,330277,8421441,6025612,ITH,ITH5
2022-02-24T17:00:00,ITA,06,Friuli Venezia Giulia,45.6494354,13.76813649,271,16,287,20923,21210,-606,810,280341,4760,,,306311,5726104,1082015,"Il totale dei casi positivi è stato ridotto di 6 a seguito di 1 tampone molecolare negativo dopo test antigenico positivo (1 caso relativo alla provincia di GO) e a seguito di 5 test positivi rimossi dopo revisione dei casi (2 casi relativi alla provincia di TS, 3 casi relativi alla provincia di PN )		 Si segnala che nei dati relativi agli ospedalizzati in Terapia Intensiva e Area Medica sono conteggiati tutti i pazienti risultati positivi a SARS-CoV2 ricoverati sia per Covid-19 che per altra patologia.  Dei 18 decessi odierni  6 sono riferiti a casi pregressi, relativi ai mesi dì novembre e dicembre 2021 e gennaio 2022.",3,,,181562,124749,3052322,2673782,ITH,ITH4
2022-02-24T17:00:00,ITA,12,Lazio,41.89277044,12.48366722,1553,140,1693,162596,164289,-6407,5361,884280,10376,,,1058945,17547172,5374223,,20,,,827981,230964,8047825,9499347,ITI,ITI4
2022-02-24T17:00:00,ITA,07,Liguria,44.41149315,8.9326992,395,24,419,15687,16106,-94,1250,320431,5079,,,341616,4744288,1225440,"Si precisa che nel flusso informativo degli ospedalizzati in Area Medica e Terapia Intensiva sono conteggiati tutti i pazienti SARS-CoV2 positivi ricoverati sia per patologia Covid-19 correlata sia per altre causa. Inoltre, si fa presente che i pazienti attualmente ospedalizzati per patologia non Covid-19 correlata ammontano a circa il 30% del totale degli ospedalizzati positivi per SARS-CoV2.",2,,*di cui  9314 reinfezioni a partire dal 3/09/2021 [circ. min sal. n.37911 del 20/08/2021].,212923,128693,2273141,2471147,ITC,ITC3
2022-02-24T17:00:00,ITA,03,Lombardia,45.46679409,9.190347404,1196,110,1306,123327,124633,-5418,5239,2155732,38468,,,2318833,32799725,7794041,,2,,,1318161,1000672,14976947,17822778,ITC,ITC4
2022-02-24T17:00:00,ITA,11,Marche,43.61675973,13.5188753,231,29,260,22785,23045,-70,1791,295760,3573,,,322378,2705726,1721742,,1,,,201421,120957,1908408,797318,ITI,ITI3
2022-02-24T17:00:00,ITA,14,Molise,41.55774754,14.65916051,23,3,26,6474,6500,-54,296,31000,565,,,38065,477491,425566,,0,,,22244,15821,369625,107866,ITF,ITF2
2022-02-24T17:00:00,ITA,21,P.A. Bolzano,46.49933453,11.35662422,85,3,88,6705,6793,-242,581,178288,1411,,,186492,3630917,620350,,1,,,89428,97064,843021,2787896,ITH,ITH1
2022-02-24T17:00:00,ITA,22,P.A. Trento,46.06893511,11.12123097,65,7,72,4264,4336,-24,387,132248,1513,,,138097,2370390,531299,,0,,,42395,95702,821289,1549101,ITH,ITH2
2022-02-24T17:00:00,ITA,01,Piemonte,45.0732745,7.680687483,1072,43,1115,47939,49054,-877,2192,909781,13005,,,971840,15089711,3703748,,1,,,473436,498404,4684801,10404910,ITC,ITC1
2022-02-24T17:00:00,ITA,16,Puglia,41.12559576,16.86736689,689,44,733,82574,83307,-789,3652,632455,7612,,,723374,8636501,2090472,,3,,,438857,284517,3955152,4681349,ITF,ITF4
2022-02-24T17:00:00,ITA,20,Sardegna,39.21531192,9.110616306,348,26,374,33458,33832,-629,1499,136359,2022,,,172213,3732005,1451991,,1,,"L'incremento dei nuovi casi tiene conto anche dei casi diagnosticati con test antigenico, ai sensi di quando disposto con Ordinanza n. 2 del 3 febbraio 2022 del Presidente della Regione Sardegna. Pertanto si specifica che dei 1499 casi dichiarati oggi, 1214 sono stati diagnosticati da tampone antigenico Si segnala il decesso dei paz.:  - 1 donna 79 aa Residente nella Provincia del Sud Sardegna  - 1 donna 91 aa Residente nella Città Metropolitana di Cagliari  - 1 uomo 84 aa Residente nella Provincia di Sassari  - 1 uomo 89 aa Residente nella Provincia di Oristano  - 1 donna 85 aa Residente nella Provincia di Oristano  - 1 donna 97 aa Residente nella Provincia di Oristano  - 1 deceduto nella Provincia di Nuoro",140380,31833,1766188,1965817,ITG,ITG2
2022-02-24T17:00:00,ITA,19,Sicilia,38.11569725,13.3623567,1130,69,1199,229575,230774,-1104,4776,530734,9379,,,770887,10697034,5133700,DECEDUTI: N. 9 IL 23/02/2022 - N. 12 IL 22/02/2022 - N. 3 IL 21/02/2022 - N. 1 IL 20/02/2022 - N. 1 IL 19/02/2022 - N. 1 IL 13/02/2022 - N. 2 IL 29/01/2022 - N. 1 IL 22/01/2022 - N. 1 IL 17/01/2022 - N. 1 IL 15/01/2022,0,,"Sul numero complessivo dei casi confermati comunicati in data odierna, n. 1333 sono relativi a giorni precedenti al 23/02/22 (di cui: N. 1002 IL 22/02/2022 - N. 192 IL 21/02/2022 - N. 18 IL 20/02/2022 - N. 16 IL 19/02/2022 - N. 17 IL 18/02/2022			",478276,292611,4349470,6347564,ITG,ITG1
2022-02-24T17:00:00,ITA,09,Toscana,43.76923077,11.25588885,894,69,963,37596,38559,-2300,2993,800506,8917,,,847982,12095747,4333890,,6,,,550115,297867,6338146,5757601,ITI,ITI1
2022-02-24T17:00:00,ITA,10,Umbria,43.10675841,12.38824698,158,6,164,10163,10327,-179,777,169537,1725,,,181589,3673851,653102,- Si fa presente che 8 dei ricoveri non UTI appartengono ai codici disciplina di Ostetricia & Ginecologia e Pediatria. - Si fa presente che 8 dei ricoveri non UTI appartengono ad altri codici disciplina.,1,,,117059,64530,1517159,2156692,ITI,ITI2
2022-02-24T17:00:00,ITA,02,Valle d'Aosta,45.73750286,7.320149366,31,4,35,1389,1424,0,39,29360,518,,,31302,465019,127798,,1,,,13840,17462,134310,330709,ITC,ITC2
2022-02-24T17:00:00,ITA,05,Veneto,45.43490485,12.33845213,722,53,775,62817,63592,-813,4111,1240578,13790,,,1317960,25453846,4538784,Nei valori riportati per le terapie intensive si è verificato un disallineamento temporale del flusso informativo pertanto per convenzione è stato riportato  6 dimessi da TI  invece del n. 4 effettivi che include anche i negativizzati.,7,,,742031,575929,9271030,16182816,ITH,ITH3
