data,stato,codice_regione,denominazione_regione,lat,long,ricoverati_con_sintomi,terapia_intensiva,totale_ospedalizzati,isolamento_domiciliare,totale_positivi,variazione_totale_positivi,nuovi_positivi,dimessi_guariti,deceduti,casi_da_sospetto_diagnostico,casi_da_screening,totale_casi,tamponi,casi_testati,note,ingressi_terapia_intensiva,note_test,note_casi,totale_positivi_test_molecolare,totale_positivi_test_antigenico_rapido,tamponi_test_molecolare,tamponi_test_antigenico_rapido,codice_nuts_1,codice_nuts_2
2022-02-26T17:00:00,ITA,13,Abruzzo,42.35122196,13.39843823,391,13,404,61086,61490,-8672,1135,197691,2950,,,262131,5003348,1164531,Dal totale dei positivi è stato eliminato un caso in quanto già segnalato da altra regione.,0,,,156589,105542,2059933,2943415,ITF,ITF1
2022-02-26T17:00:00,ITA,17,Basilicata,40.63947052,15.80514834,107,3,110,19504,19614,-54,491,62130,752,,,82496,802398,306359,"Il numero totale dei decessi ne comprende n. 29 a carico di pazienti non residenti, deceduti in strutture ospedaliere della Regione Basilicata. ",2,,,57849,24647,614455,187943,ITF,ITF5
2022-02-26T17:00:00,ITA,18,Calabria,38.90597598,16.59440194,282,22,304,45806,46110,-411,1136,164615,2079,,,212804,2262589,1730142,"L'ASP di Cosenza  comunica :""Nel setting fuori regione si registrano: 12 nuovi casi a domicilio, 1 decesso di un paziente ricoverato e 1 guarito a domicilio"".",1,,,162958,49846,1494395,768194,ITF,ITF6
2022-02-26T17:00:00,ITA,15,Campania,40.83956555,14.25084984,796,50,846,136957,137803,-2410,3578,1054338,9725,,,1201866,13706128,4569888,,3,,"a seguito delle verifiche quotidiane si evince che 5 decessi registrati oggi, risalgono ad un periodo compreso tra il 25/01 e il 23/02 2022",846481,355385,8038348,5667780,ITF,ITF3
2022-02-26T17:00:00,ITA,08,Emilia-Romagna,44.49436681,11.3417208,1407,79,1486,36897,38383,-1816,2223,1128205,15874,,,1182462,14486639,2627416,"Sono stati eliminati 1 casi, positivi a test antigenico ma non confermati da tampone molecolare.",2,,,849102,333360,8440028,6046611,ITH,ITH5
2022-02-26T17:00:00,ITA,06,Friuli Venezia Giulia,45.6494354,13.76813649,215,13,228,19877,20105,-544,637,282745,4771,,,307621,5750172,1083466,"Il totale dei casi positivi è stato ridotto di 8 a seguito di 3 tamponi molecolari negativi dopo test antigenico positivo (2 casi relativi alla provincia di UD e 1 caso relativo alla provincia di GO) e a seguito di 5 test positivi rimossi dopo revisione dei casi (2 casi relativi alla provincia di TS, 1 caso relativo alla provincia di PN e 2 casi relativi alla provincia UD).		 Si segnala che nei dati relativi agli ospedalizzati in Terapia Intensiva e Area Medica sono conteggiati tutti i pazienti risultati positivi a SARS-CoV2 ricoverati sia per Covid-19 che per altra patologia.		",2,,,182044,125577,3063289,2686883,ITH,ITH4
2022-02-26T17:00:00,ITA,12,Lazio,41.89277044,12.48366722,1447,131,1578,148115,149693,-6686,4482,908356,10407,,,1068456,17645141,5381677,"Dei decessi comunicati in data odierna, 9 sono riferibili alla settimana 14-20/02/2022 ",7,,,832266,236190,8075461,9569680,ITI,ITI4
2022-02-26T17:00:00,ITA,07,Liguria,44.41149315,8.9326992,348,23,371,14762,15133,-482,1008,323538,5090,,,343761,4767629,1227914,,0,,*di cui  9438 reinfezioni a partire dal 3/09/2021 [circ. min sal. n.37911 del 20/08/2021].,213605,130156,2279796,2487833,ITC,ITC3
2022-02-26T17:00:00,ITA,03,Lombardia,45.46679409,9.190347404,1103,98,1201,120732,121933,-1759,4408,2167370,38537,,,2327840,32924319,7805165,,0,,,1320651,1007189,15009868,17914451,ITC,ITC4
2022-02-26T17:00:00,ITA,11,Marche,43.61675973,13.5188753,213,26,239,19887,20126,-2923,1268,301519,3580,,,325225,2715308,1729298,,0,,,201936,123289,1911891,803417,ITI,ITI3
2022-02-26T17:00:00,ITA,14,Molise,41.55774754,14.65916051,22,3,25,6116,6141,-57,280,31870,567,,,38578,481808,429876,,0,,,22312,16266,371182,110626,ITF,ITF2
2022-02-26T17:00:00,ITA,21,P.A. Bolzano,46.49933453,11.35662422,72,3,75,5962,6037,-264,559,180078,1413,,,187528,3642563,621141,"559 nuovi positivi di cui 6 test antigenici confermati da test molecolare e 518 test antigenici. A questi sono stati sottratti 2 storni di pazienti positivi al test antigenico ma negativi a test molecolare eseguito entro 3 giorni, per un totale netto di 516 positivi a test antigenico comunicati",0,,,89506,98022,844031,2798532,ITH,ITH1
2022-02-26T17:00:00,ITA,22,P.A. Trento,46.06893511,11.12123097,56,6,62,3872,3934,-178,279,133200,1514,,,138648,2378609,532261,,0,,,42413,96235,821920,1556689,ITH,ITH2
2022-02-26T17:00:00,ITA,01,Piemonte,45.0732745,7.680687483,969,39,1008,46173,47181,-775,1826,915410,13023,,,975614,15165877,3710382,,4,,,474111,501503,4694889,10470988,ITC,ITC1
2022-02-26T17:00:00,ITA,16,Puglia,41.12559576,16.86736689,624,39,663,80245,80908,-1437,3315,641582,7636,,,730126,8690517,2097211,,2,,,440446,289680,3968273,4722244,ITF,ITF4
2022-02-26T17:00:00,ITA,20,Sardegna,39.21531192,9.110616306,340,23,363,31317,31680,-1138,1091,140815,2032,,,174527,3752299,1457328,,1,,"L'incremento dei nuovi casi tiene conto anche dei casi diagnosticati con test antigenico, ai sensi di quando disposto con Ordinanza n. 2 del 3 febbraio 2022 del Presidente della Regione Sardegna. Pertanto si specifica che dei 1091 casi dichiarati oggi, 838 sono stati diagnosticati da tampone antigenico. Si segnala il decesso dei paz.:  - 1 donna 92 aa Residente nella Città Metropolitana di Cagliari  - 1 uomo 75 aa Residente nella Provincia di Oristano ",140907,33620,1773490,1978809,ITG,ITG2
2022-02-26T17:00:00,ITA,19,Sicilia,38.11569725,13.3623567,1046,77,1123,228716,229839,-1325,3358,540517,9424,,,779780,10758477,5194395,"Sul numero complessivo dei casi confermati comunicati in data odierna, n. 995 sono relativi a giorni precedenti al 25/02/22			",9,,DECEDUTI: N. 1 IL 26/02/2022 - N. 11 IL 25/02/2022 - N. 9 IL 24/02/2022 - N. 2 IL 23/02/2022 - N. 2 IL 22/02/2022 - N. 1 IL 04/02/2022 - N. 1 IL 03/02/2022 - N. 1 IL 20/01/2022 - N. 1 IL 16/01/2022,479146,300634,4359828,6398649,ITG,ITG1
2022-02-26T17:00:00,ITA,09,Toscana,43.76923077,11.25588885,842,57,899,33249,34148,-2396,2363,809804,8980,,,852932,12146855,4343898,,6,,,552092,300840,6353301,5793554,ITI,ITI1
2022-02-26T17:00:00,ITA,10,Umbria,43.10675841,12.38824698,148,7,155,9876,10031,-251,729,171434,1729,,,183194,3689325,654799,- Si fa presente che 4 dei ricoveri non UTI appartengono ai codici disciplina di Ostetricia & Ginecologia e Pediatria. - Si fa presente che 4 dei ricoveri non UTI appartengono ad altri codici disciplina.,0,,,117622,65572,1520535,2168790,ITI,ITI2
2022-02-26T17:00:00,ITA,02,Valle d'Aosta,45.73750286,7.320149366,31,3,34,1345,1379,-24,26,29472,519,,,31370,466533,128035,,0,,,13829,17541,134417,332116,ITC,ITC2
2022-02-26T17:00:00,ITA,05,Veneto,45.43490485,12.33845213,644,48,692,58198,58890,-1764,4183,1253017,13814,,,1325721,25583548,4545054,Nei valori riportati per le terapie intensive si è verificato un disallineamento temporale del flusso informativo pertanto per convenzione è stato riportato 7 dimessi da TI  invece del n. 3 effettivi che include anche i negativizzati.,5,,,743738,581983,9292533,16291015,ITH,ITH3
